13
###############################
#p  SS ** *  1 * 2 *  * * *   #
#G# #B#*# # #*#*# # # #*#*#*# #
#GFx*B TT ***  *  1   * 2 * * #
#P# # # # #*# # #*#*# # # # #*#
#f         x **  *  *   1     #
# # # # # # # # # #*# #*# # # #
#*  *      *  *      *        #
# # # # #*# # # #*#*# # # # # #
#*    **  *       *           #
# #*# # # # # # #*# # # # # # #
#           *   *  *          #
###############################