13
###############################
#p      x *  2 *   *  * * *   #
# # # #*# # #*#*# # # #*#*#*# #
#   *     ***  *      *   * * #
# # # # # #*# # #*#*# # # # #*#
#f     4     **  *  *         #
# # # # # # # # # #*# #*# # # #
#*  *      *  *      *    3   #
# # # # #*# # # #*#*# # # # # #
#*    **  *       *           #
# #*# # # # # # #*# # # # # # #
#  1        *   *  *    2     #
###############################