13
###############################
#p                 2          #
#                             #
#                             #
#                            *#
#                             #
#                             #
#*  *      *  *      *        #
#                             #
#*    **  *       *           #
#                             #
#           *   *  *          #
###############################