13
###############################
#p     x       P    2         #
#                             #
#c    V                       #
#     P       1              *#
#c    G                       #
#           1                 #
#*  *      *  *      *        #
#                             #
#*    **  *       *           #
#                             #
#           *   *  *          #
###############################