13
###############################
#p     x            2         #
#                             #
#c    V                       #
#             1              *#
#c    G                       #
#           1                 #
#*  *      *  *      *        #
#                             #
#*    **  *       *           #
#                             #
#           *   *  *          #
###############################